WildBits 10 10 444 240 13 7
26 0 27 0 27 0 27 0 27 0 27 0 27 0 27 0 27 0 28 0
39 0 40 0 40 0 40 0 40 0 40 0 40 0 40 0 40 0 41 0
39 0 0 1 40 0 1 1 40 0 40 0 40 0 40 0 40 0 41 0
39 0 13 1 40 0 14 1 40 0 40 0 40 0 40 0 40 0 41 0
78 1 79 1 79 1 79 1 47 0 79 1 79 1 79 1 79 1 80 1
26 0 27 0 27 0 27 0 40 0 27 0 27 0 27 0 27 0 28 0
39 0 40 0 40 0 40 0 40 0 40 0 40 0 40 0 40 0 41 0
39 0 0 1 40 0 1 1 40 0 40 0 40 0 40 0 40 0 41 0
39 0 13 1 40 0 14 1 40 0 40 0 40 0 40 0 40 0 41 0
78 1 79 1 79 1 79 1 79 1 79 1 79 1 79 1 79 1 80 1